XXXXXXXXXXXXXXX
XXXXXXXXXXXXXXX
XX           XX
XX XXXXXXXXX XX
XX     X   X XX
XXXXX    X X XX
XX    S  X X XX
XX XX    X X XX
XX     X X X XX
XXX XX X X X XX
X X XX X X X XX
X X    X X X XX
X   XX   X   XX
XXXXXXXXXXXXXXX
XXXXXXXXXXXXXXX
